TYRIAN
TYRIAN
ASTEROID101
ASTEROID202
SAVARA
MINES
BUBBLES
DELIANI
ASTEROID?02
MINEMAZE
BONUS
HOLES
SAVARA
SOH
WINDY
ASSASSIN
SAVARA
**


lvl1 enemies
3,  4,  5,  6,  7,  8,  9, 10, 12, 13, 14, 15, 17, 18, 19, 20, 21, 22, 23, 24,
25, 26, 27, 28, 29, 30, 31, 32, 33, 34, 35, 36, 37, 38, 39, 40, 41, 42, 43, 44,
45, 46, 47, 48, 49, 50, 51, 52, 53, 54, 55, 56, 57, 58, 59, 60, 61, 62, 63, 64,
65, 66, 67, 68, 69, 70, 71, 72, 73, 74, 75, 76, 77, 78, 79, 121, 125,
468, 469, 470, 471, 472, 473,
516, 517, 518, 519, 520, 521, 522, 523, 524, 525, 526, 527